Moi! Mitä kuuluu?	Hi! How are you?
Terve, pitkästä aikaa!	Hey, long time no see!
Ajattelin vain laittaa viestiä.	I just thought I'd send a message.
Toivottavasti sinulla menee hyvin.	I hope you're doing well.
Olisiko sinulla hetki aikaa?	Would you have a moment?
Olen tässä suunnitellut pientä juttua.	I've been planning a little something.
Haluaisin kutsua sinut meille.	I would like to invite you to our place.
Pidetään pienet juhlat.	Let's have a little party.
Järjestän illanistujaiset ensi viikonloppuna.	I'm organizing a get-together next weekend.
Mitäs sanoisit, jos tulisit käymään?	What would you say to stopping by?
Olet lämpimästi tervetullut!	You are warmly welcome!
Täytän vuosia ja ajattelin juhlistaa sitä.	It's my birthday and I thought I'd celebrate.
Järjestän tuparit uuden asunnon kunniaksi.	I'm having a housewarming party for the new apartment.
Pidetään valmistujaisjuhlat.	Let's have a graduation party.
Ajattelin pitää pikkujoulut.	I was thinking of having a pre-Christmas party.
Juhlat ovat lauantaina 15. marraskuuta.	The party is on Saturday, the 15th of November.
Aloitellaan noin kello 18.	Let's start around 6 PM.
Voit tulla milloin sinulle sopii seitsemän jälkeen.	You can come whenever it suits you after seven.
Paikkana on meidän koti.	The place is our home.
Osoite on Esimerkkikatu 1 A 2.	The address is Esimerkkikatu 1 A 2.
Juhlat jatkuvat myöhään.	The party will go on late.
Sopiiko tämä päivä sinulle?	Does this day work for you?
Kerrothan, jos et pääse.	Please let me know if you can't make it.
Tarjolla on pientä syötävää ja juotavaa.	There will be some snacks and drinks on offer.
Keitän kahvit ja leivon jotain hyvää.	I'll make coffee and bake something nice.
Grillataan, jos sää sallii.	We'll have a barbecue if the weather permits.
Ajattelin tehdä ison kattilallisen keittoa.	I was thinking of making a big pot of soup.
Tuo vain itsesi ja hyvä mieli.	Just bring yourself and a good mood.
Sinun ei tarvitse tuoda mitään.	You don't need to bring anything.
Jos haluat tuoda jotain, voit tuoda vaikka sipsejä.	If you want to bring something, you could bring some crisps, for example.
Juhlat ovat nyyttikestiperiaatteella.	The party is a potluck.
Minä hoidan suolaiset, voisitko sinä tuoda jotain makeaa?	I'll handle the savory stuff, could you bring something sweet?
Ota omat juomat mukaan (O.P.M.).	Bring your own drinks (BYOB).
Muutama ystävä on myös tulossa.	A few other friends are also coming.
Meitä on pieni porukka kasassa.	We'll be a small group.
Tulossa on noin kymmenen henkeä.	About ten people are coming.
Pukukoodi on rento.	The dress code is casual.
Voit pukeutua ihan tavallisesti.	You can dress normally.
Laita jotain vähän juhlavampaa päälle.	Wear something a little more festive.
Meillä on sauna päällä.	We'll have the sauna on.
Ota uikkarit ja pyyhe mukaan, jos haluat saunoa.	Bring a swimsuit and a towel if you want to go to the sauna.
Voin lainata sinulle pyyhkeen.	I can lend you a towel.
Ilmoitathan tulostasi viimeistään perjantaina.	Please confirm your attendance by Friday at the latest.
Vastausta pyydetään (V.P.) 10. päivään mennessä.	RSVP by the 10th.
Kerrothan, pääsetkö tulemaan, ruokamäärän arvioimiseksi.	Please let me know if you can make it, to estimate the amount of food.
Ilmoita myös mahdollisista allergioista.	Also, let me know about any possible allergies.
Toivottavasti pääset paikalle!	I hope you can make it!
Olisi todella kiva nähdä.	It would be really nice to see you.
Nähdään lauantaina!	See you on Saturday!
Tervetuloa juhlimaan kanssamme!	Welcome to celebrate with us!
Jos eksyt, soita minulle.	If you get lost, call me.
Numeroni on 040 123 4567.	My number is 040 123 4567.
Meille pääsee helposti bussilla numero 5.	You can get to our place easily with bus number 5.
Lähin pysäkki on aivan talon edessä.	The nearest stop is right in front of the building.
Jos tulet autolla, kadun varressa on parkkipaikkoja.	If you come by car, there are parking spots along the street.
Ovikoodi on 1234.	The door code is 1234.
Asumme kolmannessa kerroksessa.	We live on the third floor.
Soita ovikelloa, jossa lukee Virtanen.	Ring the doorbell that says Virtanen.
Tämä on vain epävirallinen kutsu.	This is just an informal invitation.
Älä stressaa lahjasta.	Don't stress about a gift.
Paras lahja on, kun tulet paikalle.	The best gift is you being there.
Mitä mieltä olet?	What do you think?
Kiinnostaisiko lähteä leffaan?	Would you be interested in going to the movies?
Mennäänkö keikalle?	Shall we go to a gig?
Ajattelin järjestää peli-illan.	I was thinking of organizing a game night.
Tule katsomaan uutta asuntoamme.	Come and see our new apartment.
Pidetään pienet tuparit.	Let's have a small housewarming party.
Meillä on vähän viiniä ja juustoja.	We have some wine and cheese.
Voit ottaa myös ystäväsi mukaan.	You can bring your friend along too.
Mitä enemmän, sen parempi.	The more, the merrier.
Tule sellaisena kuin olet.	Come as you are.
Aloitetaan juhlat skumpalla.	Let's start the party with some sparkling wine.
Tarkoituksena on viettää rento ilta yhdessä.	The idea is to spend a relaxed evening together.
Ei mitään virallista, kunhan hengaillaan.	Nothing official, just hanging out.
Olen kaivannut sinua!	I've missed you!
Siitä onkin aikaa, kun viimeksi nähtiin.	It's been a while since we last saw each other.
Päivitetään kuulumiset.	Let's catch up.
Laitoin kutsun myös Facebookissa.	I also sent an invitation on Facebook.
Voit vastata siellä.	You can reply there.
Jos et pääse, ei haittaa. Järjestetään jotain toiste.	If you can't make it, no worries. We'll organize something another time.
Yritä päästä tulemaan!	Try to make it!
Sinun seuraasi kaivataan.	Your company is wanted.
Juhlat eivät ole mitään ilman sinua.	The party is nothing without you.
Tulethan?	You'll come, right?
Odotan innolla!	I'm looking forward to it!
Nähdään pian!	See you soon!
Terveisin, [Oma Nimi]	Regards, [Your Name]
Rakkaudella, [Oma Nimi]	With love, [Your Name]
Halauksin, [Oma Nimi]	Hugs, [Your Name]
Muista ilmoittaa tulostasi.	Remember to confirm your attendance.
Vastaa tähän viestiin.	Reply to this message.
Laita viestiä, jos on kysyttävää.	Send a message if you have any questions.
Odotan vastaustasi.	I'm waiting for your reply.
Toivottavasti nähdään!	Hope to see you!
